"filename", "language", "Java", "comment", "blank", "total"
"/Users/nghsinkai/Library/Mobile Documents/com~apple~CloudDocs/NTU/Y2S2/OOP/Sudoku/sudoku/Cell.class", "Java", 25, 0, 0, 25
"/Users/nghsinkai/Library/Mobile Documents/com~apple~CloudDocs/NTU/Y2S2/OOP/Sudoku/sudoku/Cell.java", "Java", 125, 22, 14, 161
"/Users/nghsinkai/Library/Mobile Documents/com~apple~CloudDocs/NTU/Y2S2/OOP/Sudoku/sudoku/CellStatus.class", "Java", 16, 0, 0, 16
"/Users/nghsinkai/Library/Mobile Documents/com~apple~CloudDocs/NTU/Y2S2/OOP/Sudoku/sudoku/CellStatus.java", "Java", 10, 0, 1, 11
"/Users/nghsinkai/Library/Mobile Documents/com~apple~CloudDocs/NTU/Y2S2/OOP/Sudoku/sudoku/GameBoardPanel.class", "Java", 21, 0, 0, 21
"/Users/nghsinkai/Library/Mobile Documents/com~apple~CloudDocs/NTU/Y2S2/OOP/Sudoku/sudoku/GameBoardPanel.java", "Java", 609, 58, 64, 731
"/Users/nghsinkai/Library/Mobile Documents/com~apple~CloudDocs/NTU/Y2S2/OOP/Sudoku/sudoku/Puzzle.class", "Java", 19, 0, 0, 19
"/Users/nghsinkai/Library/Mobile Documents/com~apple~CloudDocs/NTU/Y2S2/OOP/Sudoku/sudoku/Puzzle.java", "Java", 94, 18, 16, 128
"/Users/nghsinkai/Library/Mobile Documents/com~apple~CloudDocs/NTU/Y2S2/OOP/Sudoku/sudoku/SudokuFocusTraversalPolicy.java", "Java", 148, 10, 19, 177
"/Users/nghsinkai/Library/Mobile Documents/com~apple~CloudDocs/NTU/Y2S2/OOP/Sudoku/sudoku/SudokuMain$1.class", "Java", 11, 0, 0, 11
"/Users/nghsinkai/Library/Mobile Documents/com~apple~CloudDocs/NTU/Y2S2/OOP/Sudoku/sudoku/SudokuMain$2.class", "Java", 20, 0, 0, 20
"/Users/nghsinkai/Library/Mobile Documents/com~apple~CloudDocs/NTU/Y2S2/OOP/Sudoku/sudoku/SudokuMain.class", "Java", 29, 0, 0, 29
"/Users/nghsinkai/Library/Mobile Documents/com~apple~CloudDocs/NTU/Y2S2/OOP/Sudoku/sudoku/SudokuMain.java", "Java", 187, 28, 29, 244
"/Users/nghsinkai/Library/Mobile Documents/com~apple~CloudDocs/NTU/Y2S2/OOP/Sudoku/sudoku/WelcomePage.java", "Java", 289, 19, 47, 355
"Total", "-", 1603, 155, 190, 1948